hint=Reminder
none=None
login=Login
administrator="As Admin"
sure=OK
firstPage="First"
prePage="Previous"
nextPage="Next"
lastPage="Last"
search="Search"
cancel="Cancel"
close="Close"
save="Save"
edit="Edit"
delte="Delete"
starTime="Start Time"
endTime="End time"
details=Details
VA="V/A Mode"
typeV="Voltage"
typeA="Current"
nextStep="Next"
preStep="Previous"
nextSaveStep="Save And Next"
setting=Setting
reset=Reset
depth=Depth
working=Workbench
lock=Lock
unlock=Unlock
finish=Finish
testPress=Test
success=Success
fail=Fail
online=Online
offline=Offline
unknown=Unknown
connect=Connect
reconn=Reconnect
CANstatus="CAN Status"
test=Test
warnType=Mode
pulseCount=Pulses
steps=Spacing
counts="Depth"
sheaveTop="Top Sheave"
sheaveBt="Bottom Sheave"
measuringHead="Measuring Head"
up="up"
down="down"
reverse="Reverse"
macId="Machine Code"
authCode="Auth Code"
# 弹窗提示消息
dataSource="Data Sources"
local="Location"
groundSys="Ground System"
info1="No changes selected"
info2="Please confirm deletion，it will be permanently deleted."
info3="Delete cancelled"
info4="Finished"
info5="Equipment storage space is full, please clean it in time."
info6="Equipment storage has reached 70%，Please export data in time."
info7="After the confirmation is checked, the tension alarm and braking function of the software will stop in the downward direction, and only the interface flashing prompt function is provided！"
info8="Username cannot be empty！"
info9="Password cannot be empty！"
info10="Username and password error！"
info11="You will return to main menu. Continue?"
info12="Please select a report to export."
infoTask="Please select a report to build task."
info13="Please insert a USB flash drive."
info14="Please start pressure test."
info15="Pressure test successfully."
info16="Please select a job to export."
info17="Please select a disk."
info18="Please insert a USB flash drive."
info19="Input value overranged. Input value should not higher than wire max tension."
info20="Do you want to overwrite the folder with the same name?"
info21="Export Success!"
info22="Export Failure!"
info23="Reset Success!"
info24="Reset Failure!"
info25="Leaving will stop the ongoing Pressure Test. Continue?"
info26="Operator must not be empty!"
info27="Do at least 8 ticks."
info28="Please enter a number."
info29="The scale cannot be empty."
info30="The kilogram force can only be less than."
info31="Martin wheel has been removed."
info32="The encoder has been removed."
info33="The tension gauge has been removed."
info34="The tension meter is not calibrated."
info35="Maximum 20 records!"
info36="The model already exists!"
info37="Set IP success!"
info38="Set IP address failed!"
info39="Authorization Failed!"
# 主界面导航
operateLogs="Log"
warningLogs=Alarming
device=Device
deepCorrect="Depth Cal."
scale="Tension Cal."
startchk=Start
exit=Exit

# 主页面左侧菜单
jops="Run Details"
use="Run Details"
sysSet="Settings"
psiMonitor="Press Monitoring"
controllerStatus=Controller
wellheadPressure="Well  Press"


#设备信息
tips="please binding device identification number!"
confirm=Reconfirm
deviceInfo=Configuration
company=Company
branch=Branch
department= "Project Dept."
team=Group
deviceNo="Unit ID"
version=Version

# 设备管理
device=Device
cable=Cable
winch=Winch
model=Model
factory=Manufacturer
diameter=Diameter
perimeter=Perimeter
tensile="Tensile Strength"
maxTension="Max Tension"
adds="Add"
tensiometer=Tensiometer
maxVoltage="Max Voltage"
maxA="Max Current"
maxT="Max Tension"
Martin="Martin Wheel"
encoder=Encoder
supply="Power Supply"
pulse="Pulses per second"
winchSerialNumber="Winch No"


# 绞车
winch="Winch"
winchModel="Model"
winchSeriaNumber="Winch ID"
Manufacturer="Manufacturer"
reducerModel="Gear ID"
reducerRatio="Gear Ratio"
reducerSpeedLow="Gear Ratio Low"
reducerSpeedHign="Gear Ratio High"
reducerSpeedZ1="Gear Z1"
reducerSpeedZ2="Drum Z2"
motorType="Motor Type"
motorEquivalentTorque="Motor Torque"
drumDiameter="Drum Core OD"
drumPitchDiameter="Drum Core MD"
drumBottomDiameter="Drum Core BD"


# 系统设置
 sysSet=Setting
 localhostNet="Network"
 localNet=Local
 ip="IP Address"
 netmask="Subnet Mask"
 gateway=Gateway
 telnetPort="Telnet Port"
 port=Port
 sysGorge="Ground System"
 baud="Baud Rate"
 dataBit="Date Bit"
 standard="Protocol"
 uptime="Up time"
 totalTimes="Total Duration"
 duration="Task Duration"
 runlog="Run Record"
 lastWork="Last Work Time"
 works="Work Time"
 lastRun="Last Run Time"
 runs="Run Time"
 lenth="Cable Last Running Length"
 lenths="Cable Running Length"
 sets="General"
 ymd="Date"
 hrs="Time"
 language="Language"
 zh="Simplified Chinese"
 en="English"
 speed="Speed"
 zgli="Tension"
 tension="Tension"
 port="COM Port"
#系统一般设置
year="-"
month="-"
day=''
hour=":"
minute=":"
second=""

# 深度较深
deepDraw=Configuration
deepCode="Coefficient No."
stretch="Stretch Factor"
deepAddress=Location
deepCorrect=Correct
deepSelect="Depth Coefficient Selection"
deepPerson=Operator

# 张力刻度
scale="Tension Scale"
scaleSet="Scale Configuration"
scaleModel="Scale Model"
scaleDate=Date
none=none
voltage=Voltage
current=Current
kgn=kgn
addScale="Add"


# 开始工作
startchk=Start
dataSpaceSettings="Data Space"
dataSpace="Used Space"
deleteTheSelected=Delete
projectSelection="Select Project"
project=Project
import=Import
unitSelection="Select Unit"
chooseToDrive="Select Drive"
projectName="Project Name"
ropeSettings="Wire Selection"
rope=Type
measuringHeadSelection="Measuring Head Selection"
encoderModel="Encoder Model"
deepResult="Depth Correction"
deepTime="Correction Date"
location=Location
angle=Angle
tensiometerSelectionAndSetting=Tensiometer
securityTension="Secure Setting"
tensionSet="Tension Setting"
range=Range
police=Warning
brake=Brake
differentialTensionSafetyParameterSetting="Differential Tension Setting"
speedSafetySetting="Speed Setting"
depthSafetySetting="Depth Setting"
totalDepth=Total
depthPreset=Preset
hints="Parameter setting completed，get to work!"
differential_tension="Differential Tension"
securitySettings="Security Setting"
operatingParameterSelection=Parameters
jobInformationConfirmation="Work Info"
jobModify=Modify
wellhead="Well Head"
wellheadLimit="Head Limit"
wellBottomLimit="Bottom Limit"
totalDepth="Total Depth"
specialWork="Special Work"
plc="PLC Status"
# 操作日志
operateLogs="Logs"
operCotent=Content
operator=Operator
operateType=Options
operate=Operate
operDate=Date
operdetails='Details'

# 报警记录
warningLogs=Warning
taskName=Task
preset=Preset
alertime="Warning Time"
viewLine="Graph"
alarmLine="Warning Records"
warnDetails="Details"

# 作业信息
troops=Team
construction=Task
district=District
jobType=Type
wellname="Well Name"
groundSysType="Ground System"
startStopTime=Date
unStart="Not start"
doing="Doing"
unExport="Unexported"
exported="Exported"
jobdetails=Details

# 压力监控
sysPsi="Main Press"
negPsi="Negative Press"
assistPsi="Control Press"
winchPsi="Winch Oil Press"
airPsi="Air Press"
generatorPsi="Engine Oil Press"
exportReport="Export"
exportSelection="Export"
errorCode="Error Code"
ranges="Value Range"
errorCause="Fault Cause"
solve="Problem Solution"
magnetism="Magnetic Marker Detector"
magneticMark="Magnetic Mark"
magneticMarkSpace="Magnetic Mark Spacing"
# 井口信息
wellInfo="Well Info"
GenerateAndExportReports = "Export"
deviceName="Device"
productModel="Model"
factoryNumber="Factory Number"
pressureTestingDate=Date
nameOfPressureTester=Operator
pressureTestingAddress=Location
startPressureTesting=Start
endPressureTesting=Stop
equipmentWellheadPressureTest=Pressure
pressureTestingReportList=Reports
status=Status
testPressInfo="Test Pressure Details"
#控制器参数
speedController="Speed Controller"
inputInformation="Input info."
outputInformation="Output Info."
speedControllerInputlnformation="Speed Controller Input info"
powerSupply="Supply Voltage"
handleOutput="Handle Voltage"

workState="Running State"
normal="Normal"
slowDown="Reduce"
brake="Brake"
workDirection="Work Direction"
speedSelectorSwitch="Speed Switch"
low="Low"
mediumSpeed="Medium"
highSpeed="High"
generator="Engine"
speedControlleroutputInformation="Speed Controller Output Info"
pumpACurrent="Pump A"
pumpBCurrent="Pump B"
motorCCurrent="Motor C"
brakeOutputVoltage="Brake Vol"
ultraLowOutputVoltage="Ultra-low Speed"
torqueControl="Torque Control"
generatoroutputVoltage="Engine Output Info"
outputVoltage="Output Voltage"
outputCurrent="Output Ct"
frequency="AC frequency"
activePower="Active Power"
coderReverse="Encoder Reverse"
orqueControl="Torque Control"
rotateAngel="Rotate Angel"
rotateVoltage="Rotate Vol"

drumTorque="Drum Torque"
bottomTension="Bottom-Diameter Tension"
drumTension="Mid-Diameter Tension"
largeTension="OD Tension"
currentMoment="Ct"
max="Max"
top=High
bottom=Low
rangeTop='H-grade'
rangeLov='L-grade'

