# create by vsz
# 全局设置
# 字符串有空格,需要要双引号引用
# 通用
hint=提示
none=无
all=全选
year=年
month=月
day=日
hour=时
minute=分
second=秒
login="登 录"
operate=操作
close=关闭
VA=类别
typeV=电压型
typeA=电流型
operateType=类别
warnType=类别
firstPage="首 页"
prePage=上一页
nextPage=下一页
lastPage="尾 页"
search="查 询"
sure="确 定"
cancel="取 消"
save="保 存"
edit="修 改"
delte="删 除"
add="添 加"
exit="退出"
confirm=再次确认
shutdown=关机
administrator=管理员
language="中英切换"
starTime=开始时间
endTime=结束时间
dateRange=时间范围
tips="首次使用，请绑定设备识别号"
company=公司
branch=分公司
department=项目部
team=小队
securitySettings="安全设置"
operatingParameterSelection=工作参数选择
jobInformationConfirmation=工作信息确认
jobModify=作业信息修改
nextStep=保存并下一步
preStep=上一步
nextSaveStep=保存并下一步
setting=设置
reset=复位
testPress=试压
pulseCount=脉冲
steps=间距
counts=深度
macId=机器码
authCode=授权码
# 压力监控界面
psiMonitor="压力监测与诊断"
sysPsi=系统压力表
negPsi=负压表
assistPsi=辅助系统压力表
winchPsi=绞车补油压力表
airPsi=气压表
generatorPsi=发电机补油压力表
exportReport=导出报告
exportSelection=导出选中
errorCode=故障代码
ranges=标准值
errorCause=可能故障原因
solve=故障可能部位及建议解决方法
success=成功
fail=失败

# 作业信息
jops=作业信息
use=使用信息
troops=队别
construction=施工任务
district=区域
jobType=作业方式
wellname=井名
groundSysType=地面系统类别
groundSys=地面系统
startStopTime=起止时间
unStart="未开始"
doing="进行中"
unExport="未导出"
exported="已导出"
jobdetails=作业详情

# 操作日志
operateLogs=操作日志
operateType=名称
operCotent=内容
operator=操作员
operDate=操作时间
operdetails='日志详情'

# 系统设置
sysSet=系统设置
localhostNet=本机网络
localNet=本地网络
ip=IP地址
netmask=子网掩码
gateway=网关
telnetPort=远程服务端口
port=端口
sysGorge=地面系统串口
baud=波特率
dataBit=数据位
standard=标准
uptime=开机时间
totalTimes=开机时长
duration=本次作业时长
test="测 试"
lastRun=本次运转时间
lastWork=本次作业时间
runs=累计运转时间
works=累计作业时间
lenth=缆绳本次运行长度
lenths=缆绳累计运行长度
reconn="重 连"

#设备信息
deviceInfo=设备信息
userNo=用户
deviceNo=设备识别号
version=版本号
runlog=运转记录
sets=一般设置
ymd=日期
hrs=时间
language=语言
zh=中文
en=英文
speed=速度
zgli=张力
tension=张力
differential_tension=微分张力
shen=深度
depth=深度
# 设备管理
device=设备管理
cable=缆绳
winch=绞车
model=型号名称
factory=生产厂家
diameter=直径
perimeter=周长
tensile=拉抗强度
maxTension=允许最大张力
adds=添加
tensiometer=张力计
maxVoltage='最大量程 电压'
maxA='最大量程 电流'
maxT='最大量程 张力'
Martin=马丁轮
encoder=编码器
coderReverse=编码器反转
supply=供电电压
pulse="脉冲数/转"
motorType=马达类型
winchModel=绞车型号
reducerModel=减速器型号
reducerRatio=减速器速比
reducerSpeedLow=减速器速比(低)
reducerSpeedHign=减速器速比(高)
reducerSpeedZ1=减速器链轮齿数Z1
reducerSpeedZ2=滚筒链轮齿数Z2
motorEquivalentTorque=马达当量扭矩
drumDiameter=滚筒大径
drumPitchDiameter=滚筒中径
drumBottomDiameter=滚筒底径
winchSerialNumber=绞车序列号(识别号)
Manufacturer=生产厂家
plc="PLC状态"
online=在线
offline=离线
unknown=未知
connect=连接
CANstatus=CAN状态

# 深度较深
deepCorrect=深度校深
deepDraw=深度拉伸系数设置
deepCode=校深编号
deepAddress=校深地点
stretch=拉伸系数
deepSelect=深度校深系数选择
deepPerson=操作员

# 张力刻度
scale=张力刻度
scaleSet=张力刻度
scaleModel=张力计型号
scaleDate=刻度时间
none=无
voltage=电压
current=电流
kgn=公斤力
addScale=添加刻度
reverse="反转"

# 开始工作
startchk=开始工作
dataSpaceSettings=数据空间设置
dataSpace=空间使用情况
deleteTheSelected=删除选中
projectSelection=项目选择
project=项目
import=导入
unitSelection=单位选择
chooseToDrive=选择盘符
projectName=项目名称
ropeSettings=缆绳选择
rope=缆绳
measuringHeadSelection=测量头选择
encoderModel=编码器型号
deepResult=校深结果
deepTime=校深时间
location=位置
angle=角度
tensiometerSelectionAndSetting=张力计选择与设置
securityTension=安全张力
tensionSet=张力设置
range=量程
police=报警
brake=刹车
specialWork=特殊作业
differentialTensionSafetyParameterSetting=微分张力设置
speedSafetySetting=速度设置
depthSafetySetting=深度设置
totalDepth=总深度
depthPreset=深度预置
hints="参数设置完成，即将开始工作!"
wellhead=井口段
wellheadLimit=井口段限速
wellBottomLimit=井底段限速
totalDepth=总深度
magnetism=磁记号探测器
magneticMark=磁记号
magneticMarkSpace=磁记号间隔距离
up="上行"
down="下行"
# 弹窗提示消息
dataSource="数据来源"
info1="选择不能为空"
info2="此操作将永久删除记录"
info3="已取消删除"
info4="删除成功"
info5="存储空间已满，请及时清理"
info6="存储已达到70%, 请注意导出数据"
info7="下行方向时，张力报警与刹车功能将失效，仅提供界面闪烁提示功能"
info8="用户名不能为空"
info9="密码不能为空"
info10="密码不匹配"
info11="此操作将退出到主界面，是否确定退出？"
info12="请先选择要导出的报告"
info13="请插入U盘! 确认插入后,关闭弹窗,重新导出"
info14="请先开始试压"
info15="成功结束试压"
info16="请先选择要导出的施工任务"
info17="请选择盘符"
info18="请插入U盘,确认插入后，关闭弹窗，重新导出"
info19="量程不能大于缆绳设置的最大张力"
info20="文件夾已存在，是否覆盖"
info21="导出成功"
info22="导出失败"
info23="重置成功"
info24="重置失败"
info25="当前正在试压，切换页面将结束试压"
info26="操作员不能为空"
info27="至少进行8次刻度"
info28="请输入数字"
info29="刻度不能为空"
info30="公斤力只能小于"
info31="马丁轮已被删除"
info32="编码器已被删除"
info33="张力计已被删除"
info34="张力计未刻度"
info35="最多只能新建20条"
info36="该型号已经存在"
info37="设置地址成功"
info38="设置地址失败"
info39="授权失败"
sheaveTop="天滑轮"
sheaveBt="地滑轮"
measuringHead="测量头"
# 报警记录
warningLogs=报警记录
taskName=任务名称
preset=预设值
alertime=报警时间
viewLine=查看曲线
alarmLine=报警曲线
warnDetails="报警详情"

# 井口信息
wellInfo=井口信息
wellheadPressure=井口试压
GenerateAndExportReports = 生成并导出报告
deviceName=设备名称
productModel=产品型号
factoryNumber=出厂编号(设备识别号)
pressureTestingDate=试压日期
nameOfPressureTester=操作员
pressureTestingAddress=试压地址
startPressureTesting=开始试压
endPressureTesting=结束试压
equipmentWellheadPressureTest=试压压力
pressureTestingReportList=试压报告列表
status=状态
testPressInfo=试压详情

#控制器参数
controllerStatus=控制器与发电机状态监测与诊断
speedController=速度控制器
inputInformation=输入信息
outputInformation=输出信息
pumpACurrent=泵A电流
pumpBCurrent=泵B电流
motorCCurrent=马达C电流
brakeOutputVoltage=刹车输出电压
ultraLowOutputVoltage=超低速输出电压
generator=发电机
outputVoltage=输出电压
outputCurrent=输出电流
frequency=频率
activePower=有功功率
rotateOutput=旋钮输出电压
rotateAngel=旋钮角度
rotateVoltage=旋钮电压
torqueControl=扭力控制
workDirection=工作方向
torqueParameters=扭力参数
workState=工作状态
normal=正常
slowDown=减速
speedSelectorSwitch=速度选择开关
low=低速
mediumSpeed=中速
highSpeed=高速
powerSupply=电源供电
handleOutput=手柄输出
currentMoment=当前
max=最大
drumTorque=滚筒扭矩
bottomTension=滚筒底径拉力
drumTension=滚筒中径拉力
largeTension=滚筒大径拉力
working=工作界面
lock=锁屏
unlock=解锁
local=本地
finish=结束
top=高
bottom=低
rangeTop='高档'
rangeLov='低档'






















































